1111111111111111111
1010P1110011C000011
11EC000C01001001011
100C100000001000101
11101010001C0C10C11
1101001000CC1010111
110C010101000C11011
10110110001100111C1
1100000100011011101
1000110010010C00001
1000100C10011000011
10110C011100001C011
1000100110101C10111
1111111111111111111